+..+--+--+--+--+--+--+--+--+--+--+--+--+--+--+--+--+--+--+--+--+--+--+--+--+
|..|   .. .. ..|        |        |        |            .. ..|      .. ..|  |
+..+--+..+--+..+  +--+  +  +--+  +  +--+  +  +--+--+--+..+..+--+--+..+..+  +
|..|.. ..|.. ..|     |     |     |  |  |     |.. ..|.. ..|.. .. .. ..|..|  |
+..+..+--+..+--+--+  +--+--+  +--+  +  +--+--+..+..+..+--+--+--+--+--+..+  +
|..|..|  |..|        |           |           |..|.. ..|        |.. .. ..|  |
+..+..+  +..+  +  +--+--+--+--+--+  +--+--+  +..+--+--+--+--+..+..+--+--+..+
|..|..|  |..|  |  |              |  |.. ..|  |.. ..|.. .. ..|.. ..|.. .. ..|
+..+..+  +..+--+  +  +--+--+--+  +  +..+..+  +--+..+..+--+..+..+--+..+--+..+
|.. ..|  |.. ..|           |  |     |..|..|     |.. ..|.. ..|.. .. ..|  |..|
+--+--+  +--+..+--+--+--+  +  +--+--+..+..+--+--+--+  +..+--+--+--+--+..+..+
|           |..|.. ..|        |.. .. ..|.. .. .. ..|  |.. .. ..|     |.. ..|
+  +--+--+  +..+..+..+  +--+--+..+--+--+--+--+--+..+  +--+--+..+  +--+..+--+
|     |  |  |..|..|..|     |.. ..|     |        |..|  |.. ..|..|     |..|  |
+--+  +  +  +..+..+..+--+--+..+--+  +  +--+  +  +..+--+..+..+..+--+  +..+..+
|     |     |..|..|.. .. ..|.. ..|  |        |  |.. ..|..|.. ..|     |.. ..|
+  +--+--+  +..+..+--+--+..+  +..+  +--+  +--+--+--+..+..+--+--+  +  +--+..+
|  |     |  |..|..|  |.. ..|  |..|  |     |        |.. ..|        |  |.. ..|
+  +  +  +--+..+..+  +..+--+--+..+  +--+--+  +  +--+--+--+  +  +--+--+..+--+
|     |      .. ..|   .. .. .. ..|           |              |         .. ..|
+--+--+--+--+--+--+--+--+--+--+--+--+--+--+--+--+--+--+--+--+--+--+--+--+..+

